{
  "time_limit": 300,
  "orders": [
    {
      "item_type": "Food2",
      "target_amount": 6
    },
    {
      "item_type": "Food1",
      "target_amount": 12
    }
  ],
  "items": [
    "Food2",
    "Food2",
    "Food2",
    "Food2",
    "Food2",
    "Food2",
    "Food1",
    "Food1",
    "Food1",
    "Food1",
    "Food1",
    "Food1",
    "Food1",
    "Food1",
    "Food1",
    "Food1",
    "Food1",
    "Food1",
    "Food3",
    "Food3",
    "Food3",
    "Food3",
    "Food3",
    "Food3",
    "Food3",
    "Food3",
    "Food3",
    "Food3",
    "Food3",
    "Food3",
    "Food3",
    "Food3",
    "Food3",
    "Food3",
    "Food3",
    "Food3",
    "Food3",
    "Food3",
    "Food3",
    "Food3",
    "Food3",
    "Food3",
    "Food3",
    "Food3",
    "Food3",
    "Food3",
    "Food3",
    "Food3",
    "Food3",
    "Food3",
    "Food3",
    "Food3",
    "Food3",
    "Food3",
    "Food3",
    "Food3",
    "Food3",
    "Food3",
    "Food4",
    "Food4",
    "Food4",
    "Food4",
    "Food4",
    "Food4",
    "Food4",
    "Food4",
    "Food4",
    "Food4",
    "Food4",
    "Food4",
    "Food4",
    "Food4",
    "Food4",
    "Food4",
    "Food4",
    "Food4",
    "Food4",
    "Food4",
    "Food4",
    "Food4",
    "Food4",
    "Food4",
    "Food4",
    "Food4",
    "Food4",
    "Food4",
    "Food4",
    "Food4",
    "Food4",
    "Food4",
    "Food4",
    "Food4",
    "Food4",
    "Food4",
    "Food4",
    "Food4"
  ]
}