{
  "time_limit": 300,
  "orders": [
    {
      "item_type": "Food3",
      "target_amount": 15
    }
  ],
  "items": [
    "Food3",
    "Food3",
    "Food3",
    "Food3",
    "Food3",
    "Food3",
    "Food3",
    "Food3",
    "Food3",
    "Food3",
    "Food3",
    "Food3",
    "Food3",
    "Food3",
    "Food3",
    "Food1",
    "Food1",
    "Food1",
    "Food1",
    "Food1",
    "Food1",
    "Food1",
    "Food1",
    "Food1",
    "Food1",
    "Food1",
    "Food1",
    "Food1",
    "Food1",
    "Food1",
    "Food1",
    "Food1",
    "Food1",
    "Food1",
    "Food1",
    "Food2",
    "Food2",
    "Food2",
    "Food2",
    "Food2",
    "Food2",
    "Food2",
    "Food2",
    "Food2",
    "Food2",
    "Food2",
    "Food2",
    "Food2",
    "Food2",
    "Food2",
    "Food2",
    "Food2",
    "Food2",
    "Food2",
    "Food2",
    "Food4",
    "Food4",
    "Food4",
    "Food4",
    "Food4",
    "Food4",
    "Food4",
    "Food4",
    "Food4",
    "Food4",
    "Food4",
    "Food4",
    "Food4",
    "Food4",
    "Food4",
    "Food4",
    "Food4",
    "Food4",
    "Food4",
    "Food4",
    "Food1",
    "Food1",
    "Food1",
    "Food1",
    "Food1",
    "Food2",
    "Food2",
    "Food2",
    "Food2",
    "Food2",
    "Food1",
    "Food1",
    "Food1",
    "Food1",
    "Food1",
    "Food2"
  ]
}