{
  "time_limit": 300,
  "orders": [
    {
      "item_type": "Food4",
      "target_amount": 9
    },
    {
      "item_type": "Food1",
      "target_amount": 6
    },
    {
      "item_type": "Food3",
      "target_amount": 3
    }
  ],
  "items": [
    "Food4",
    "Food4",
    "Food4",
    "Food4",
    "Food4",
    "Food4",
    "Food4",
    "Food4",
    "Food4",
    "Food1",
    "Food1",
    "Food1",
    "Food1",
    "Food1",
    "Food1",
    "Food3",
    "Food3",
    "Food3",
    "Food2",
    "Food2",
    "Food2",
    "Food2",
    "Food2",
    "Food2",
    "Food2",
    "Food2",
    "Food2",
    "Food2",
    "Food2",
    "Food2",
    "Food2",
    "Food2",
    "Food2",
    "Food2",
    "Food2",
    "Food2",
    "Food2",
    "Food2",
    "Food2",
    "Food2",
    "Food2",
    "Food2",
    "Food2",
    "Food2",
    "Food2",
    "Food2",
    "Food2",
    "Food2",
    "Food2",
    "Food2",
    "Food2",
    "Food2",
    "Food2",
    "Food2",
    "Food2",
    "Food2",
    "Food2",
    "Food2",
    "Food2",
    "Food2",
    "Food2",
    "Food2",
    "Food2",
    "Food2",
    "Food2",
    "Food2",
    "Food2",
    "Food2",
    "Food2",
    "Food2",
    "Food2",
    "Food2",
    "Food2",
    "Food2",
    "Food2",
    "Food2",
    "Food2",
    "Food2",
    "Food2",
    "Food2",
    "Food2",
    "Food2",
    "Food2",
    "Food2",
    "Food2",
    "Food2",
    "Food2",
    "Food2",
    "Food2",
    "Food2",
    "Food2",
    "Food2",
    "Food2",
    "Food2",
    "Food2",
    "Food2"
  ]
}