{
  "time_limit": 300,
  "orders": [
    {
      "item_type": "Food1",
      "target_amount": 12
    },
    {
      "item_type": "Food4",
      "target_amount": 9
    }
  ],
  "items": [
    "Food1",
    "Food1",
    "Food1",
    "Food1",
    "Food1",
    "Food1",
    "Food1",
    "Food1",
    "Food1",
    "Food1",
    "Food1",
    "Food1",
    "Food4",
    "Food4",
    "Food4",
    "Food4",
    "Food4",
    "Food4",
    "Food4",
    "Food4",
    "Food4",
    "Food2",
    "Food2",
    "Food2",
    "Food2",
    "Food2",
    "Food2",
    "Food2",
    "Food2",
    "Food2",
    "Food2",
    "Food2",
    "Food2",
    "Food2",
    "Food2",
    "Food2",
    "Food2",
    "Food2",
    "Food2",
    "Food2",
    "Food2",
    "Food2",
    "Food2",
    "Food2",
    "Food2",
    "Food2",
    "Food2",
    "Food2",
    "Food2",
    "Food2",
    "Food2",
    "Food2",
    "Food2",
    "Food2",
    "Food2",
    "Food2",
    "Food2",
    "Food2",
    "Food2",
    "Food3",
    "Food3",
    "Food3",
    "Food3",
    "Food3",
    "Food3",
    "Food3",
    "Food3",
    "Food3",
    "Food3",
    "Food3",
    "Food3",
    "Food3",
    "Food3",
    "Food3",
    "Food3",
    "Food3",
    "Food3",
    "Food3",
    "Food3",
    "Food3",
    "Food3",
    "Food3",
    "Food3",
    "Food3",
    "Food3",
    "Food3",
    "Food3",
    "Food3",
    "Food3",
    "Food3",
    "Food3",
    "Food3",
    "Food3",
    "Food3",
    "Food3",
    "Food3"
  ]
}